
NO textures/SW-WALL.xpm
SO textures/SW-WALL.xpm
WE textures/NE-WALL.xpm
EA textures/NE-WALL.xpm 

F 225, 211, 157
C 230, 227, 193

111111111111111
100000000000001
10W000000000001                          111111   
10000001111000111111111                  1000011111111111111111111111111111111111111111111111
100000000010001000000011111111111111111  1000000000000000000000000000000000000000000000000001   
100000000000000000000000000000000000001111000001111111000000000000000000010110000000000000001
100000000000011000000011111111111110000000000001001001000000000000000000101001000000000000001
10000000000001111111001           111111110000000000000000000000000000000101100000000000000011
1000001000000010000000111111111111111000000001111111111000000000000000000000000000000000000001
1000000000000010000000000000000000000000000011        1111111111111111111000000000000000000011
100000001000001000000011110000000011111111111                           111111111111111111111
10000000000000111111111  1111111111   
111111111111111