
  NO textures/north.xpm              
  SO textures/north.xpm         
WE textures/north.xpm     
      EA textures/north.xpm  

        F255,   166 ,         45
        C      255,   166 ,         0

   
        1111111111111111  111111111  
      111000000000110001111000001
      101011000001110000000000001
      1110010000000000   00000001
111111111011000001110000000000001
100000000011000001110111111111111
11110111111111011100000010001
11110111111111011101010010001
11000000110101011100000010001
10000000000000001100000010001
10000000000000001101010010001    
11000001110101011111011110N0111
11110111 1110101 101111010001
11111111 1111111 111111111111