
  NO textures/north.xpm              
  SO textures/north.xpm         
WE textures/north.xpm     
      EA textures/north.xpm  

        F255,   166 ,         45
        C      255,   166 ,         0

   

0
11111111
111111111
100000001
111111111
111111111
100000001
111111111
111111111
100000001
111111111
 111111111
100000001
  111111111


                       