
NO textures/north.xpm              
SO textures/north.xpm         
WE textures/north.xpm     
EA textures/north.xpm  

F 255, 166, 45
C 255, 166, 0

111111111111111
100000000000001
10N000000000001
100000010000001
100000000010001
100000000000001
100000000000011
100000000000011
100000000000001
100000000000001
100000000000001
100000000000001
111111111111111