
NO textures/player_spr_backward.xpm        
SO textures/player_spr_backward.xpm  
WE textures/enemy_sprite.xpm 
EA textures/enemy_sprite.xpm 

F 255, 166, 45
C 255, 166, 0

111111111111111
100000000000001
10N000000000001
10000001111000111111111
10000000001000100000001
10000000000000000000001
10000000000001100000001
10000000000001111111001
10000010000000100000001
10000000000000100000001
10000000100000100000001
10000000000000111111111
111111111111111